111001111000000
001001000000100
001000000000100
000001000000100
000001000011111
000001000011111
100011000010001
100010000010001
100011001110001
001011000110001
101011000010001
100001000011011
000000000011011
000001100001010
000001100000000
